||||||||     |||| | |                        |
                                              
         |          |           |            |
         |||||||||||||||||||||||||||||||||||||
                                           |||
|||||||||||||  |||                           |
||||||||||||||||||||||||||| ||||||||||||||||||