||||||||     |||| | |                        |
                                              
         |          |           |            |
         |||||||||||||||||||||||||||||||||||||
                                           |||
|||||||||||||||| |                           |
||||||||||||||||||||||||||| ||||||||||||||||||