||||||||     |||| | |                        |
                                              
         |          |           |            |
         |||||||||||||||||||||||||||||||||||||
                                           |||
||||||||||||||||||                           |
||||||||||||||||||||||||||| ||||||||||||||||||